|--------|
|...|.._.|
|..-|.@..|
|......_.|
|--------|
